"aa" = (/turf/open/space/basic,/area/deathmatch)
"ab" = (/turf/closed/indestructible/alien,/area/template_noop)
"ac" = (/turf/closed/indestructible/alien,/area/deathmatch)
"ad" = (/obj/structure/table/reinforced,/obj/item/mecha_ammo/lmg,/obj/item/mecha_ammo/lmg{pixel_y = 12},/obj/item/mecha_ammo/scattershot{pixel_y = 18},/obj/item/mecha_ammo/scattershot{pixel_y = 24},/turf/open/floor/carpet/neon/simple/yellow,/area/template_noop)
"ae" = (/obj/structure/table/reinforced,/obj/item/mecha_parts/mecha_equipment/weapon/ballistic/lmg{pixel_y = -8},/obj/item/mecha_parts/mecha_equipment/weapon/ballistic/scattershot{pixel_y = 8},/turf/open/floor/carpet/neon/simple/yellow,/area/template_noop)
"af" = (/turf/open/floor/carpet/neon/simple/yellow,/area/template_noop)
"ag" = (/obj/machinery/door/poddoor/shutters{id_tag = "dm1"},/turf/open/floor/engine,/area/template_noop)
"ah" = (/turf/open/floor/engine,/area/template_noop)
"ai" = (/turf/closed/wall/mineral/plastitanium,/area/template_noop)
"aj" = (/turf/open/floor/engine,/area/deathmatch)
"ak" = (/obj/structure/barricade/security,/turf/open/floor/engine,/area/deathmatch)
"al" = (/turf/open/floor/carpet/neon/simple/green,/area/template_noop)
"am" = (/obj/structure/table/reinforced,/obj/item/mecha_parts/mecha_equipment/weapon/ballistic/lmg{pixel_y = -8},/obj/item/mecha_parts/mecha_equipment/weapon/ballistic/scattershot{pixel_y = 8},/turf/open/floor/carpet/neon/simple/green,/area/template_noop)
"an" = (/obj/structure/table/reinforced,/obj/item/mecha_ammo/lmg,/obj/item/mecha_ammo/lmg{pixel_y = 12},/obj/item/mecha_ammo/scattershot{pixel_y = 18},/obj/item/mecha_ammo/scattershot{pixel_y = 24},/turf/open/floor/carpet/neon/simple/green,/area/template_noop)
"ao" = (/obj/structure/table/reinforced,/obj/item/clothing/head/welding,/obj/item/weldingtool,/obj/item/inducer/sci,/turf/open/floor/carpet/neon/simple/yellow,/area/template_noop)
"ap" = (/obj/structure/tank_holder/extinguisher,/turf/open/floor/carpet/neon/simple/red,/area/template_noop)
"aq" = (/obj/structure/barricade/security,/turf/open/floor/engine,/area/template_noop)
"ar" = (/turf/open/floor/carpet/neon/simple/red,/area/template_noop)
"as" = (/obj/structure/table/reinforced,/obj/item/clothing/head/welding,/obj/item/weldingtool,/obj/item/inducer/sci,/turf/open/floor/carpet/neon/simple/green,/area/template_noop)
"at" = (/obj/vehicle/sealed/mecha/combat/gygax,/turf/open/floor/carpet/neon/simple/yellow,/area/template_noop)
"au" = (/turf/open/lava,/area/deathmatch)
"av" = (/turf/open/lava,/area/template_noop)
"aw" = (/obj/vehicle/sealed/mecha/combat/gygax,/turf/open/floor/carpet/neon/simple/green,/area/template_noop)
"ax" = (/turf/closed/wall/mineral/plastitanium,/area/deathmatch)
"ay" = (/obj/machinery/door/airlock/hatch,/turf/open/floor/carpet/neon/simple/purple,/area/template_noop)
"az" = (/obj/machinery/door/airlock/hatch,/turf/open/floor/carpet/neon/simple/lime,/area/deathmatch)
"aA" = (/obj/machinery/vending/cigarette,/turf/open/floor/engine,/area/deathmatch)
"aB" = (/obj/machinery/vending/assist,/turf/open/floor/engine,/area/deathmatch)
"aC" = (/obj/machinery/vending/sustenance,/turf/open/floor/engine,/area/template_noop)
"aD" = (/turf/open/floor/carpet/neon/simple/violet,/area/template_noop)
"aE" = (/turf/open/floor/carpet/neon/simple/lime,/area/deathmatch)
"aF" = (/mob/living/carbon/human/species/monkey/angry,/turf/open/floor/engine,/area/deathmatch)
"aG" = (/obj/item/chair,/turf/open/floor/engine,/area/deathmatch)
"aH" = (/obj/item/mecha_parts/mecha_equipment/antiproj_armor_booster,/turf/open/floor/engine,/area/deathmatch)
"aI" = (/obj/structure/showcase/machinery/cloning_pod,/turf/open/floor/engine,/area/deathmatch)
"aJ" = (/turf/open/floor/carpet/neon/simple/red,/area/deathmatch)
"aK" = (/turf/open/floor/carpet/neon/simple/violet,/area/deathmatch)
"aL" = (/obj/structure/table_frame,/turf/open/floor/carpet/neon/simple/violet,/area/deathmatch)
"aM" = (/obj/effect/decal/cleanable/blood/gibs,/turf/open/floor/engine,/area/deathmatch)
"aN" = (/obj/structure/showcase/horrific_experiment,/turf/open/floor/engine,/area/deathmatch)
"aO" = (/obj/effect/decal/cleanable/blood/drip,/turf/open/floor/engine,/area/deathmatch)
"aP" = (/obj/machinery/door/airlock/hatch,/turf/open/floor/engine,/area/deathmatch)
"aQ" = (/obj/structure/chair/office,/turf/open/floor/engine,/area/deathmatch)
"aR" = (/obj/effect/decal/cleanable/blood/splatter,/turf/open/floor/engine,/area/deathmatch)
"aS" = (/obj/structure/table,/turf/open/floor/engine,/area/deathmatch)
"aT" = (/obj/structure/barricade/sandbags,/turf/open/floor/engine,/area/template_noop)
"aU" = (/obj/structure/barricade/sandbags,/turf/open/floor/engine,/area/deathmatch)
"aV" = (/obj/machinery/door/airlock/hatch,/turf/open/floor/carpet/neon/simple/purple,/area/deathmatch)
"aW" = (/obj/structure/chair{icon_state = "chair"; dir = 1},/turf/open/floor/engine,/area/deathmatch)
"aX" = (/obj/machinery/door/airlock/hatch,/turf/open/floor/engine,/area/template_noop)
"aY" = (/obj/structure/table,/turf/open/floor/carpet/neon/simple/violet,/area/deathmatch)
"aZ" = (/obj/structure/barricade/security,/turf/open/floor/carpet/neon/simple/violet,/area/deathmatch)
"ba" = (/obj/structure/table,/obj/item/mecha_parts/mecha_equipment/repair_droid,/turf/open/floor/engine,/area/deathmatch)
"bb" = (/obj/structure/table/reinforced,/obj/item/gun/energy/laser,/turf/open/floor/engine,/area/deathmatch)
"bc" = (/obj/structure/table_frame,/turf/open/floor/engine,/area/deathmatch)
"bd" = (/turf/open/floor/carpet/neon/simple/orange,/area/template_noop)
"be" = (/obj/vehicle/sealed/mecha/combat/gygax,/turf/open/floor/carpet/neon/simple/orange,/area/deathmatch)
"bf" = (/obj/vehicle/sealed/mecha/combat/gygax,/turf/open/floor/carpet/neon/simple/teal,/area/template_noop)
"bg" = (/turf/open/floor/carpet/neon/simple/teal,/area/template_noop)
"bh" = (/obj/structure/table/reinforced,/obj/item/clothing/head/welding,/obj/item/inducer/sci,/obj/item/weldingtool/largetank,/turf/open/floor/carpet/neon/simple/orange,/area/template_noop)
"bi" = (/obj/structure/barricade/security,/turf/open/floor/carpet/neon/simple/red,/area/deathmatch)
"bj" = (/obj/structure/table,/obj/item/storage/belt/janitor,/turf/open/floor/engine,/area/template_noop)
"bk" = (/obj/structure/table,/obj/item/reagent_containers/glass/bucket,/turf/open/floor/engine,/area/template_noop)
"bl" = (/obj/structure/table,/obj/item/mop,/turf/open/floor/engine,/area/template_noop)
"bm" = (/obj/structure/janitorialcart{icon_state = "cart"; dir = 4},/turf/open/floor/engine,/area/template_noop)
"bn" = (/obj/item/storage/bag/trash,/turf/open/floor/engine,/area/template_noop)
"bo" = (/obj/structure/closet/l3closet/janitor,/turf/open/floor/engine,/area/template_noop)
"bp" = (/obj/machinery/vending/wardrobe/jani_wardrobe,/turf/open/floor/engine,/area/template_noop)
"bq" = (/obj/machinery/door/poddoor/shutters{id_tag = "dm4"},/turf/open/floor/engine,/area/template_noop)
"br" = (/obj/structure/table/reinforced,/obj/item/clothing/head/welding,/obj/item/weldingtool,/obj/item/inducer/sci,/turf/open/floor/carpet/neon/simple/teal,/area/template_noop)
"bs" = (/obj/structure/table/reinforced,/obj/item/mecha_ammo/lmg,/obj/item/mecha_ammo/lmg{pixel_y = 12},/obj/item/mecha_ammo/scattershot{pixel_y = 18},/obj/item/mecha_ammo/scattershot{pixel_y = 24},/turf/open/floor/carpet/neon/simple/orange,/area/template_noop)
"bt" = (/obj/structure/table/reinforced,/obj/item/mecha_parts/mecha_equipment/weapon/ballistic/lmg{pixel_y = -8},/obj/item/mecha_parts/mecha_equipment/weapon/ballistic/scattershot{pixel_y = 8},/turf/open/floor/carpet/neon/simple/orange,/area/template_noop)
"bu" = (/obj/machinery/button{id = null; id_tag = "dm1"},/turf/open/floor/carpet/neon/simple/red,/area/template_noop)
"bv" = (/obj/structure/table/reinforced,/obj/item/mecha_parts/mecha_equipment/weapon/ballistic/lmg{pixel_y = -8},/obj/item/mecha_parts/mecha_equipment/weapon/ballistic/scattershot{pixel_y = 8},/turf/open/floor/carpet/neon/simple/teal,/area/template_noop)
"bw" = (/obj/structure/table/reinforced,/obj/item/mecha_ammo/lmg,/obj/item/mecha_ammo/lmg{pixel_y = 12},/obj/item/mecha_ammo/scattershot{pixel_y = 18},/obj/item/mecha_ammo/scattershot{pixel_y = 24},/turf/open/floor/carpet/neon/simple/teal,/area/template_noop)
"bx" = (/obj/effect/landmark/deathmatch_player_spawn,/obj/effect/turf_decal/box,/turf/open/floor/carpet/neon/simple/yellow,/area/template_noop)
"by" = (/obj/effect/landmark/deathmatch_player_spawn,/obj/effect/turf_decal/box,/turf/open/floor/carpet/neon/simple/green,/area/template_noop)
"bz" = (/obj/effect/turf_decal/trimline/yellow/filled/warning,/turf/open/floor/engine,/area/deathmatch)
"bA" = (/obj/effect/turf_decal/trimline/yellow/filled/warning,/turf/open/floor/engine,/area/template_noop)
"bB" = (/obj/effect/turf_decal/trimline/yellow/filled/warning{icon_state = "trimline_warn_fill"; dir = 4},/turf/open/floor/engine,/area/deathmatch)
"bC" = (/obj/effect/turf_decal/trimline/yellow/filled/warning{icon_state = "trimline_warn_fill"; dir = 8},/turf/open/floor/engine,/area/deathmatch)
"bD" = (/obj/effect/turf_decal/trimline/yellow/filled/warning{icon_state = "trimline_warn_fill"; dir = 4},/turf/open/floor/engine,/area/template_noop)
"bE" = (/obj/effect/turf_decal/trimline/yellow/filled/warning{icon_state = "trimline_warn_fill"; dir = 8},/turf/open/floor/engine,/area/template_noop)
"bF" = (/obj/effect/turf_decal/trimline/yellow/filled/warning{icon_state = "trimline_warn_fill"; dir = 1},/turf/open/floor/engine,/area/deathmatch)
"bG" = (/obj/machinery/button{id_tag = "dm4"},/turf/open/floor/carpet/neon/simple/purple,/area/template_noop)
"bH" = (/obj/structure/reagent_dispensers/fueltank,/turf/open/floor/engine,/area/deathmatch)
"bI" = (/obj/effect/turf_decal/trimline/yellow/filled/warning{icon_state = "trimline_warn_fill"; dir = 1},/turf/open/floor/engine,/area/template_noop)
"bJ" = (/obj/structure/table/reinforced,/obj/item/mecha_parts/mecha_equipment/weapon/energy/laser/heavy,/turf/open/floor/engine,/area/deathmatch)
"bK" = (/obj/machinery/light/directional/west,/turf/open/floor/engine,/area/template_noop)
"bL" = (/obj/structure/reagent_dispensers/water_cooler,/turf/open/floor/engine,/area/deathmatch)
"bM" = (/obj/structure/barricade/wooden,/turf/open/floor/engine,/area/template_noop)
"bN" = (/obj/machinery/door/airlock/hatch,/turf/open/floor/carpet/neon/simple/teal,/area/template_noop)
"bO" = (/obj/item/gun/energy/laser/hellgun,/obj/structure/closet/crate/trashcart/filled,/turf/open/floor/engine,/area/deathmatch)
"bP" = (/obj/machinery/stasis,/turf/open/floor/engine,/area/template_noop)
"bQ" = (/obj/structure/barricade/wooden,/turf/open/floor/carpet/neon/simple/teal,/area/template_noop)
"bR" = (/turf/open/floor/carpet/neon/simple/teal,/area/deathmatch)
"bS" = (/obj/machinery/recharger,/obj/structure/table,/turf/open/floor/engine,/area/deathmatch)
"bT" = (/obj/structure/urinal{pixel_y = 24},/turf/open/floor/noslip,/area/deathmatch)
"bU" = (/obj/structure/reagent_dispensers/cooking_oil,/turf/open/floor/engine,/area/deathmatch)
"bV" = (/turf/open/floor/noslip,/area/deathmatch)
"bW" = (/obj/structure/toilet{icon_state = "toilet00"; dir = 8},/turf/open/floor/light,/area/deathmatch)
"bX" = (/turf/open/floor/noslip,/area/template_noop)
"bY" = (/obj/machinery/sleeper{icon_state = "sleeper"; dir = 4},/turf/open/floor/engine,/area/template_noop)
"bZ" = (/obj/vehicle/ridden/atv,/obj/item/key/atv,/turf/open/floor/engine,/area/deathmatch)
"ca" = (/obj/machinery/sleeper{icon_state = "sleeper"; dir = 8},/turf/open/floor/engine,/area/deathmatch)
"cb" = (/obj/item/grenade/smokebomb,/turf/open/floor/engine,/area/deathmatch)
"cc" = (/obj/item/mecha_parts/mecha_equipment/anticcw_armor_booster,/turf/open/floor/engine,/area/template_noop)
"cd" = (/obj/structure/barricade/wooden,/turf/open/floor/carpet/neon/simple/teal,/area/deathmatch)
"ce" = (/obj/machinery/vending/medical,/turf/open/floor/engine,/area/deathmatch)
"cf" = (/obj/structure/window/fulltile,/turf/open/floor/engine,/area/template_noop)
"cg" = (/obj/item/shard,/turf/open/floor/engine,/area/deathmatch)
"ch" = (/obj/structure/table,/obj/item/storage/briefcase,/turf/open/floor/engine,/area/deathmatch)
"ci" = (/obj/structure/table,/obj/item/storage/toolbox/mechanical,/turf/open/floor/engine,/area/deathmatch)
"cj" = (/turf/open/floor/sepia,/area/template_noop)
"ck" = (/turf/open/floor/sepia,/area/deathmatch)
"cl" = (/obj/structure/cannon{icon_state = "falconet_patina"; dir = 8},/turf/open/floor/sepia,/area/deathmatch)
"cm" = (/obj/structure/window/fulltile,/turf/open/floor/engine,/area/deathmatch)
"cn" = (/obj/structure/window,/turf/open/floor/sepia,/area/template_noop)
"co" = (/obj/item/gun/ballistic/revolver/detective,/obj/structure/table/wood,/turf/open/floor/sepia,/area/template_noop)
"cp" = (/obj/item/gun/ballistic/rifle/boltaction/pipegun,/obj/structure/table/wood,/turf/open/floor/sepia,/area/template_noop)
"cq" = (/obj/item/gun/ballistic/rifle/boltaction,/obj/structure/table/wood,/turf/open/floor/sepia,/area/template_noop)
"cr" = (/obj/structure/window{icon_state = "window"; dir = 8},/obj/item/lighter,/turf/open/floor/sepia,/area/deathmatch)
"cs" = (/obj/structure/closet/crate/trashcart/filled,/obj/item/weldingtool,/turf/open/floor/engine,/area/deathmatch)
"ct" = (/obj/structure/fermenting_barrel/gunpowder,/turf/open/floor/sepia,/area/template_noop)
"cu" = (/obj/item/stack/cannonball/fourteen,/obj/structure/table/wood,/turf/open/floor/sepia,/area/template_noop)
"cv" = (/obj/structure/table,/obj/structure/table,/obj/item/grenade/smokebomb,/turf/open/floor/engine,/area/deathmatch)
"cw" = (/obj/machinery/light/directional/east,/turf/open/floor/engine,/area/deathmatch)
"cx" = (/obj/item/mecha_ammo/scattershot,/turf/open/floor/engine,/area/deathmatch)
"cy" = (/obj/item/storage/firstaid/regular,/turf/open/floor/noslip,/area/template_noop)
"cz" = (/obj/structure/closet/crate/trashcart/filled,/obj/machinery/light/directional/west,/turf/open/floor/engine,/area/deathmatch)
"cA" = (/obj/structure/tank_holder/extinguisher,/turf/open/floor/carpet/neon/simple/red,/area/deathmatch)
"cB" = (/obj/machinery/light/directional/north,/turf/open/floor/engine,/area/deathmatch)
"cC" = (/obj/machinery/light/directional/south,/turf/open/floor/carpet/neon/simple/teal,/area/deathmatch)
"cD" = (/obj/machinery/light/directional/west,/turf/open/floor/engine,/area/deathmatch)
"cE" = (/obj/machinery/door/airlock/hatch,/turf/open/floor/carpet/neon/simple/green,/area/deathmatch)
"cF" = (/obj/structure/barricade/wooden,/turf/open/floor/carpet/neon/simple/green,/area/deathmatch)
"cG" = (/turf/open/floor/carpet/neon/simple/green,/area/deathmatch)
"cH" = (/obj/item/grenade/smokebomb,/turf/open/floor/carpet/neon/simple/green,/area/deathmatch)
"cI" = (/obj/machinery/light/directional/north,/turf/open/floor/sepia,/area/deathmatch)
"cJ" = (/turf/open/floor/light/colour_cycle/dancefloor_a,/area/deathmatch)
"cK" = (/obj/item/reagent_containers/pill/happinesspsych,/turf/open/floor/light/colour_cycle/dancefloor_b,/area/template_noop)
"cL" = (/obj/item/fireaxe,/turf/open/floor/light/colour_cycle/dancefloor_a,/area/template_noop)
"cM" = (/obj/item/reagent_containers/syringe,/turf/open/floor/light/colour_cycle/dancefloor_b,/area/deathmatch)
"cN" = (/obj/item/reagent_containers/pill/lsd,/turf/open/floor/light/colour_cycle/dancefloor_a,/area/template_noop)
"cO" = (/obj/item/reagent_containers/pill/probital,/turf/open/floor/light/colour_cycle/dancefloor_b,/area/template_noop)
"cP" = (/obj/item/reagent_containers/glass/bucket/wooden,/obj/machinery/light/directional/south,/turf/open/floor/sepia,/area/deathmatch)
"cQ" = (/obj/item/reagent_containers/food/drinks/drinkingglass/filled/nuka_cola,/turf/open/floor/light/colour_cycle/dancefloor_a,/area/template_noop)
"cR" = (/obj/item/reagent_containers/pill/stimulant,/turf/open/floor/light/colour_cycle/dancefloor_b,/area/template_noop)
"cS" = (/obj/machinery/recharge_station,/turf/open/floor/engine,/area/template_noop)
"cT" = (/obj/machinery/sheetifier,/turf/open/floor/engine,/area/deathmatch)
"cU" = (/obj/item/inducer,/obj/item/weldingtool,/turf/open/floor/engine,/area/deathmatch)
"cV" = (/obj/machinery/door/poddoor/shutters{id_tag = "dm2"},/turf/open/floor/engine,/area/template_noop)
"cW" = (/obj/machinery/grill,/turf/open/floor/engine,/area/deathmatch)
"cX" = (/obj/machinery/door/poddoor/shutters{id_tag = "dm3"},/turf/open/floor/engine,/area/template_noop)
"cY" = (/obj/machinery/sheetifier,/obj/machinery/light/directional/east,/turf/open/floor/engine,/area/deathmatch)
"cZ" = (/obj/machinery/grill,/obj/machinery/light/directional/west,/turf/open/floor/engine,/area/deathmatch)
"da" = (/obj/structure/table,/obj/item/food/meat/rawcutlet,/turf/open/floor/engine,/area/deathmatch)
"db" = (/obj/machinery/button{id_tag = "dm2"},/turf/open/floor/carpet/neon/simple/blue,/area/template_noop)
"dc" = (/obj/effect/landmark/deathmatch_player_spawn,/obj/effect/turf_decal/box,/turf/open/floor/carpet/neon/simple/orange,/area/template_noop)
"dd" = (/obj/structure/table,/obj/item/food/meat/slab/pig,/turf/open/floor/engine,/area/template_noop)
"de" = (/obj/effect/landmark/deathmatch_player_spawn,/obj/effect/turf_decal/box,/turf/open/floor/carpet/neon/simple/teal,/area/template_noop)
"df" = (/obj/machinery/button{id_tag = "dm3"},/turf/open/floor/carpet/neon/simple/pink,/area/template_noop)
"dg" = (/obj/structure/reagent_dispensers/watertank,/obj/machinery/light/directional/south,/turf/open/floor/engine,/area/template_noop)
"dh" = (/obj/machinery/light/directional/south,/turf/open/floor/engine,/area/template_noop)
"di" = (/obj/structure/table,/obj/item/food/meat/slab/bear,/turf/open/floor/engine,/area/template_noop)
"dj" = (/obj/effect/spawner/structure/window/reinforced,/turf/open/floor/engine,/area/template_noop)
"dk" = (/obj/effect/spawner/structure/window/reinforced,/turf/open/floor/engine,/area/deathmatch)
"Ij" = (/turf/open/space/basic,/area/template_noop)

(1,1,1) = {"
IjIjIjIjIjIjIjIjIjIjIjaaaaaaaaaaaaaaaaaaIjIjIjIjIjIjIjIjIjIjIjIjIj
IjababababababababababacacacacacacacacacababababababababababababIj
IjabadaeafagahahaiaparaJaJaJaJbiaJaJaJaJararararapaiahbqalamanabIj
IjabaobubxabahahaiaraqajbzajajakajajajajahbAahaqaraiahabbybGasabIj
IjabafafatabahahaXaraqbBaubCajajajajajajbDavbEaqaraXahabawalalabIj
IjabagabacacajajaxaJakbBaubCajaJaJaJaJajbBavbEaqaraiahabababbqabIj
IjabahahajajajajaxaJajajbFajajaJbbbHaJajajbIahaharaibKahahahahabIj
IjabaiaiaPaxaxaxaxaJajajbzajajaJbJbbaJajajbzajajaJaxajajahahahabIj
IjabbKahajajajajaxaJajbDavbEajaJaJaJaJajbBaubCajaJaxaxaPaiaiaiabIj
IjabcfcfcmcmcmcmaxaJajbDavbEajajajajajajbBaubCajaJaxcsajajajajacIj
IjabahbMajajajcwaxaJajahbIahakajajajajajajbFajajaJaxczajaUaUaUacIj
IjabaibNaxaxaxaxaxcAaJarararbiaJaJaJaJaJbiaJaJaJcAaxbOajajajajacIj
IjabbPbQbRcBajbSaxaxaxaidjaydkaxaxaxaxaxaxaxaxazaxaxaxaxaxajcwacIj
IjabbYahbRajbZcaaxaAaBaCahaDajajajajaxajajajcbaEajajaFajaxaUajacIj
IjabbYahbRajajcaaxajajahahaDakakakaGaxaHaIajaIaEaFaIajaIaxajajacIj
IjabccahcCcdajceaxcDaKaKaKaKaKaKaLcwaxajaIajaIaEaMaNaOaIaxajaUacIj
IjabaiaiaxcEaxaxaxbLaKajajaQajajaKajaxajajaFajaEajaRcgaFaxahahabIj
IjabbKahajcFajajaxajaKajchaSciajaKajaxaxaxaxaxazaxaxaxaxaxaXaiabIj
IjabaTaTaUcGcHcGcEaKaKajaWaWaWajaKaKaXcjcjcjcIckckclckaxcJcKcLabIj
IjabahahajcGajcwaxajakajajajajajaKajaicncncnckckckckckaPcMcNcOabIj
IjabaiaiaxcEaxaxaxajakajajajajajaKajaicocpcqcrckcPctcuaicQcRcNabIj
IjabcScSajajajajaxcDaYaKaKaKaKaZaZcwaiaiaiaiaxaPaxaiaiaiaiaiaXabIj
IjabbKahajajajcTaxajbacvajaKajakbcajaxbTbTaxbUajcUaiahahahahahabIj
IjabcVabacacajcTaxajajajajaKajajaGcxaxbVbWaxcWajajaXahabababcXabIj
IjabbdbdbeacajcYaxaxaxaxaxaVaxaxaxaxaxbVbWaxcZajdaaibKabbfbgbgabIj
IjabbhdbdcabahahaibjbkblahahbmbnbobpaicybXaiahahddaiahabdedfbrabIj
IjabbsbtbdcVahahaXahahdgahahahdhahahaXbXbXaXahahdiaiahcXbgbvbwabIj
IjabababababababababababababababababababababababababababababababIj
IjIjIjIjIjIjIjIjIjIjIjIjIjIjIjIjIjIjIjIjIjIjIjIjIjIjIjIjIjIjIjIjIj
"}
